#################################################
#       #   #   #                     #       # #
# # ### ### # # # ### ##### ######### # ##### # #
# # # #   #   # # #   #     #     #     #   # # #
### # ### # ### # # ######### ### ####### # # # #
#   #   # #   #   # #       # # #       # # #   #
# ### # # # ####### # ##### # # ####### # # ### #
# #   # # # #       # # #   # #   #   # # #   # #
# ### # # # # ##### # # # # # # # ### # # ### # #
#   # #   # # #   # # # # # # # #     # #   #   #
# # # ##### # # ### # # # ### # ##### # #########
# # # #   # # # #   #   #     #   # # # #       #
### # ### # # # # ##### ######### # # # # ##### #
#   #   #   # #       # #         #   #   #   # #
# ##### # ### ######### # ### ####### ##### # # #
# # #   # # #         # # #   #     #       # # #
# # # ### # ######### # # ##### ### ######### # #
# # #   #   #     #   # #         # #   #     # #
# # ### ### ##### # ### ######### # ### # ##### #
# #   # #   #     #   #       #   #   #     #   #
### ### # ### ##### # ####### ### ### # ##### # #
#       # #   #   # #   #   #   # #   #   #   # #
# ####### # # # # ##### # # ### ### # ##### #####
#       # # # # #     #   #         # #     #   #
####### # # ### ##### # ############### # ### # #
#     # #   #   # #   #       #     #   # #   # #
# ### # ##### ### # ######### # ### # # ### ### #
# #   # #     #     #     #   # #     # #   #   #
# # ### # ##### ####### # # ### ######### ### # #
# #   # # #     #     # # #   #     #     #   # #
# # ### # ##### ### # # # ######### # ##### ### #
# # #   #     #     #   #         #   #     #   #
# ### ####### ################### ##### ##### ###
# #   #     # # #               #     # # #   # #
# # ### ### # # # ############# ##### # # # ### #
#       #     #               #         #       #
#################################################
